#....................#
#.....K..............#
#....###.............#
#....................#
#.#..................#
#............####....#
#....................#
#.....#..............#
#.........#........#.#
#....................#
#...............##...#
#....................#
#....................#
#..........###.......#
#....................#
#..................D.#
######################
