######################
#....................#
#....................#
#.........K..........#
#........###.........#
#....................#
#....................#
#.......#.#.#........#
#................#...#
#....................#
#..................D.#
#.............##.....#
#....................#
#........##..........#
#....................#
#....................#
######################
