######################
#....................#
#....................#
#.........K..........#
#........###.........#
#....................#
#....................#
#.......#.#..........#
#....................#
#.............#......#
#..................D.#
#........#...........#
#....................#
#............#.......#
#.......#............#
#....................#
########SSSSSSSS#######
