######################
#....................#
#....................#
#.........K..........#
#........###.........#
#....................#
#....................#
#.......#.#..........#
#....................#
#.............#......#
#..................D.#
#.................##.#
#....................#
#.........S..#..#....#
#.......#.##.........#
#....................#
########SSSSSSSS######
